种类 ： 文学、社科、艺术、生活、文教
    文学 : 小说  外国小说|中国当代小说|中国古典小说|中国近现代小说|悬疑推理|科幻小说 世界名著四大名著|作品集|更多
          文学  外国诗歌|中国古诗词|中国现当代诗歌|外国散文|中国现当代散文|中国古代散文文学理论|文集|戏剧|更多
          青春文学  玄幻/科幻|悬疑/惊悚|叛逆/成长|爆笑/无厘头|校园|港台青春文学|外国青春文学更多
    社科 : 历史  中国史|世界史|地方史志|历史知识读物|史料典籍|史学理论|考古文物 民族史志
          政治/哲学  政治|军事|中国政治|国际政治|外交/国际关系哲学|宗教|美学 哲学知识读物|中国古代哲学
          传记  历代帝王|历史人物|科学家|体育明星|文学家|学者|艺术家|文娱明星政治人物|自传|更多
          文化  世界文化|中国文化|中国民俗|地域文化|文化理论|文化评述|神秘现象
          社会科学  心理学|人类学|教育|社会学|新闻传播出版|语言文字|更多
          古籍  古籍整理|经部|史类|子部|集部
          经济/管理  经济理论|中国经济|国际经济|经济通俗读物|保险|会计|金融投资 市场营销|管理学|电子商务
          成功励志  成功激励|口才演讲|名人励志|人际交往|人生哲学|心灵修养|性格习惯 更多
          法律  法的理论|法律法规|国际法|经济法|更多
    艺术 ： 绘画  绘画理论|国画|油画|素描速写|水粉水彩
            书法纂刻  碑帖|技法教程|书法理论|硬笔书法|字帖|篆刻
            摄影/设计  设计|摄影后期|摄影教程|摄影理论|摄影器材|数码摄影|作品集
            舞台影视艺术  影视理论|影视赏析|影视制作|舞台/戏曲艺术
            音乐  钢琴|吉它|理论/欣赏|声乐|通俗音乐|外国音乐|中国民族音乐|作曲/指挥
            收藏鉴赏  宝石|雕品|古代家具|钱币|收藏百科|收藏随笔|书画|陶瓷|玉器
            更多  艺术理论|雕塑|工艺美术|建筑艺术|民间艺术|人体艺术|艺术类考试
    生活 : 美食 饮食文化|保健食谱|家常食谱|八大菜系|餐饮指南|世界美食|更多
          保健/心理健康   健康百科|健身|心理健康|中老年|中医保健常见病|更多
          旅游  旅游随笔|旅游攻略|旅游画册|城市自助游|国内自助游|国外自助游|地图地理更多
          孕产  育儿孕产百科|育儿百科|更多
          更多  美丽妆扮|两性关系|家居休闲|个人理财
     文教 : 中小学教辅   语文阅读|拓展读物|高考|初中通用|高中通用|工具书教师用书|更多
            外语    英语读物|职业英语|英语考试|大学英语|少儿英语 更多
            教材    研究生/本科/专科教材 |职业技术培训|中小学教材|
            计算机   操作系统/系统开发|数据库|信息安全程序设计|电脑杂志|计算机教材|计算机考试认证计算机理论|计算机体系结构|家庭与办公室用书|企业软件开发与实施|人工智能软件工程/开发项目管理|
            更多    考试|家庭教育|自然科学|科普读物|医学|农林业|工业技术|建筑
            
            
星级 ： 1-5 星；
上架时间 : xxxx/xx/xx   xx:xx
出版时间 : xxxx/xx/xx   xx:xx